{
    "New York":[
        ["G","G","R","G","G","G","G","G","M","M"],
        ["G","G","G","G","M","M","G","G","G","G"],
        ["G","F","R","G","G","G","G","G","M","M"],
        ["F","F","R","R","G","G","G","G","M","M"],
        ["F","F","R","R","M","M","G","G","G","G"],
        ["G","F","F","R","M","M","G","G","G","G"],
        ["G","F","F","R","G","G","G","R","M","M"],
        ["G","G","G","G","G","G","G","R","G","G"],
        ["G","G","G","G","G","M","M","G","G","G"],
        ["G","G","G","R","G","G","G","R","G","G"]
    ]
}